.*********
...*..*..*
*..*...*.*
*..***...*
**...*..**
*.*......*
*.*..*...*
*****G...*
*.....*..*
**********